AAS201,ASA203,ASA238,COS126,COS226,COS217,COS333,COS342,COS423,COS432,COS484,COS522,COS528,ECO100,ECO102,ECO202,ECO300,ECO301,ECO302,ECO310,ECO312,GER101,GER103,GER105,GER107,LIN201,LIN300,MAT103,MAT104,MAT201,MAT202,MAT203,MAT204,MAT215,MAT216,MAT217,MAT218,MAT300,MAT325,MAT335,MAT370,MAT377,MAT385,MAT400,ORF245,ORF307,ORF309,ORF350,ORF363,ORF445,PHY103,PHY104,PHY105,PHY106,PHY208,REL100,REL232,SML201,URB201,AAS230,AAS244,AAS245,AAS300,AAS303,AAS306,AAS322,AAS332,AAS339,AAS350,AAS352,AAS367,AAS522,AMS101,AMS351,AMS406,ANT201,ANT211,ANT219,ANT263,ANT264,ANT300,ANT302,ANT314,ANT321,ANT337,ANT339,ANT347,ANT390,ANT437,ANT443,ANT461,ARA101,ARA105,ARA301,ARA303,ARA305,ARA403,ARC203,ARC205,ARC308,ARC311,ARC350,ARC403,ARC404,ART100,ART106,ART203,ART213,ART233,ART313,ART316,ART323,ART341,ART389,ART400,ART403,ART411,ART412,ART444,ART455,ART478,ART490,ART491,ASA201,ASL101,ASL105,ASL205,AST205,AST250,AST255,AST301,AST522,ATL494,ATL495,ATL496,ATL497,BCS105,CBE245,CBE250,CBE341,CBE351,CBE411,CBE415,CBE422,CBE430,CBE442,CEE102,CEE207,CEE305,CEE345,CEE366,CEE374,CEE375,CEE471,CHI101,CHI103,CHI105,CHI301,CHI303,CHI305,CHI403,CHI405,CHI411,CHI451,CHM201,CHM207,CHM250,CHM301,CHM305,CHM337,CHM371,CHM373,CHM403,CHM411,CLA203,CLA212,CLA219,CLA227,CLA319,CLA330,CLA340,CLG101,CLG105,CLG213,CLG301,COM300,COM302,COM310,COM351,COM370,COM372,COM421,COM456,COS109,COS240,COS302,COS316,COS324,COS326,COS350
50,73,87,44,9,100,100,31,33,60,75,37,18,27,3,8,22,78,25,62,50,59,4,55,71,75,85,22,61,75,17,9,71,76,25,70,66,22,17,45,5,13,92,52,100,44,85,67,38,65,22,75,93,9,59,91,95,89,74,14,92,32,98,57,69,6,50,58,42,31,100,40,60,90,42,19,49,37,4,21,58,48,60,12,2,19,4,65,22,55,72,92,42,68,1,58,17,42,83,75,2,66,31,77,22,64,68,14,10,35,53,29,44,86,94,95,17,36,91,3,68,73,10,7,66,40,65,55,62,100,25,93,8,19,11,96,97,65,50,90,66,19,2,57,57,23,33,47,96,14,48,83,29,41,23,68,86,74,15,52,67,91,63,6,68,39,100,60,35,56,21,74,23,35,95,67,82,66,41,66,10,54,24,57,77,25,6,74,59,46,70,98,99,20,17,41,4,2,46,98
26,96,83,2,75,82,34,79,27,17,26,52,1,,17,72,28,39,82,76,74,38,9,71,73,69,50,17,99,25,97,27,27,28,34,75,72,35,82,97,100,43,33,76,38,90,51,9,94,97,69,71,84,75,54,27,46,31,46,86,53,49,61,55,18,72,97,11,32,64,27,20,14,62,89,35,25,68,41,91,84,20,95,36,77,12,30,58,1,77,79,33,23,88,42,12,18,18,84,7,11,93,39,42,68,86,89,33,66,48,35,77,94,47,38,58,52,30,30,30,15,57,79,76,22,70,87,54,1,47,91,18,22,42,28,59,57,11,64,67,82,26,13,69,86,88,57,40,88,95,96,93,83,99,36,99,61,42,76,22,25,90,76,80,89,31,45,59,58,51,16,66,79,79,23,31,78,16,69,12,25,90,80,100,86,71,14,24,99,85,46,63,72,25,66,81,32,52,21,4
78,39,45,89,44,93,81,9,20,89,29,93,56,,35,51,61,55,89,46,16,74,83,77,1,7,38,29,69,16,50,77,76,35,90,45,11,97,31,5,73,37,90,48,73,78,31,89,43,88,61,21,11,90,32,33,85,14,19,69,3,78,75,98,83,51,22,35,75,34,13,43,90,68,45,44,65,76,92,14,51,73,57,98,50,32,79,100,100,43,73,65,68,79,78,50,9,17,16,73,45,41,11,39,59,97,99,61,34,56,32,67,28,46,37,2,,66,80,20,43,70,94,27,21,11,40,31,54,77,85,80,20,24,37,30,13,32,56,54,98,3,20,18,29,51,46,19,60,54,69,23,27,45,56,98,53,89,62,39,5,26,90,93,23,66,23,88,,35,25,72,58,36,33,61,62,42,39,41,18,70,66,18,100,21,24,10,44,26,100,62,69,44,72,60,86,,83,83
89,63,59,22,1,69,33,68,61,19,56,47,20,,45,45,4,57,10,60,39,70,28,48,47,44,72,83,62,53,3,69,46,,82,43,51,14,58,7,93,50,85,61,88,59,19,30,45,8,33,70,,68,18,9,37,79,16,21,86,66,82,72,54,45,10,97,76,23,42,19,77,14,32,26,72,19,52,58,60,22,26,1,97,38,28,36,25,23,50,4,39,72,50,41,39,41,80,79,90,76,88,63,44,37,10,5,27,88,57,62,34,7,34,18,,91,5,33,86,6,57,19,12,16,33,91,86,63,62,76,89,83,93,42,82,50,28,98,99,25,30,94,10,70,89,22,59,88,28,,39,8,20,50,60,23,99,34,92,33,6,76,57,54,88,47,,26,57,90,87,85,80,14,75,41,51,76,65,68,84,17,65,98,23,96,6,37,4,54,77,53,1,74,65,,22,51
88,93,61,88,76,32,20,17,98,,3,91,43,,8,78,95,74,51,83,98,66,20,97,63,32,67,9,24,3,42,92,64,,12,86,36,99,79,42,55,59,,25,77,86,33,76,31,19,50,60,,4,,13,71,49,41,57,100,24,87,60,62,92,3,67,74,48,54,12,7,15,60,49,52,25,10,82,52,74,88,6,89,81,85,32,61,75,65,14,49,59,100,85,26,95,77,67,77,27,81,50,35,41,96,70,58,53,8,15,18,38,63,74,,31,41,80,8,95,43,34,78,42,64,81,82,81,42,,96,53,90,18,70,49,20,85,46,99,31,93,49,37,4,68,64,6,34,,43,,9,52,1,69,11,47,27,65,24,79,91,27,36,27,,17,44,81,47,62,96,42,39,28,40,59,94,38,100,79,66,86,7,45,91,67,34,73,98,93,6,44,5,,50,42
22,71,14,21,3,1,40,97,95,,89,81,22,,59,37,84,36,36,93,52,45,1,30,42,40,93,98,,12,62,8,65,,73,29,3,13,29,37,7,16,,64,32,39,90,8,22,86,66,32,,63,,72,41,65,75,16,87,73,71,43,78,90,83,43,87,92,57,16,15,41,50,93,35,91,54,81,39,16,25,33,73,87,72,90,56,12,58,69,82,86,23,83,22,16,25,53,60,30,59,97,51,96,73,91,100,91,76,74,49,79,84,61,,46,4,62,80,100,91,5,52,18,10,38,79,50,47,,67,77,35,34,31,60,84,65,73,22,16,95,33,28,91,93,39,26,42,,15,,55,87,5,32,56,18,58,85,27,40,81,34,22,44,,82,94,63,78,94,8,18,44,79,63,52,86,100,45,9,87,33,86,49,92,35,35,40,97,21,9,2,83,,87,92
96,59,31,78,73,80,53,18,40,,31,15,71,,19,34,71,95,55,10,29,6,96,75,50,63,37,54,,95,53,15,99,,2,74,47,4,98,22,43,11,,42,29,19,,91,6,29,8,61,,14,,35,32,52,69,66,32,60,84,92,40,64,98,34,25,3,18,59,91,11,74,30,13,61,63,8,14,44,97,95,3,25,99,23,62,71,37,73,32,90,86,44,92,98,100,46,39,2,80,93,16,100,33,57,1,37,42,6,95,26,33,76,,40,37,66,91,52,72,43,20,60,67,25,91,53,77,,24,4,20,39,67,38,57,70,3,39,44,46,23,53,,50,33,79,23,,99,,44,56,29,82,90,65,32,27,99,34,12,55,68,70,,94,24,40,19,68,89,3,30,,50,1,68,13,42,68,14,15,49,39,24,4,3,15,70,8,96,30,100,,24,50
92,30,47,,78,74,26,50,,,71,57,23,,,13,73,22,54,17,9,1,16,85,24,76,10,76,,2,48,98,59,,7,96,10,66,78,32,83,9,,31,9,81,,78,32,,15,83,,10,,38,18,94,57,25,21,79,14,14,92,23,79,48,40,96,75,87,47,49,34,54,70,26,79,98,19,92,81,62,17,72,27,41,97,2,30,38,16,,64,27,30,,22,43,47,1,73,,79,51,48,38,37,22,99,18,12,70,42,86,,70,38,42,59,92,15,9,54,13,32,56,14,72,54,,84,97,70,55,2,10,72,41,50,100,51,83,52,2,,2,84,7,98,,56,,1,32,75,33,13,1,31,88,98,89,44,85,98,64,,52,2,100,9,15,16,81,2,,29,14,45,32,13,73,7,53,76,47,5,23,10,65,44,6,61,36,37,,91,37
79,34,43,,53,75,60,84,,,57,90,87,,,31,57,65,97,86,80,36,97,96,37,91,36,47,,51,13,78,,,78,78,18,18,7,,10,78,,68,3,87,,17,56,,4,100,,12,,51,78,80,83,73,,8,72,22,33,38,86,61,36,82,6,54,92,73,20,87,36,90,32,37,9,96,78,18,38,20,92,85,10,99,11,42,70,,61,26,60,,17,92,44,99,32,,21,93,28,8,67,67,16,73,73,74,50,10,,34,36,27,61,12,29,,16,78,70,57,25,24,23,,18,91,4,56,86,86,97,23,68,17,48,99,43,98,,85,75,4,100,,34,,80,93,52,73,50,79,47,71,16,39,93,4,29,62,,86,71,8,14,48,18,25,72,,85,68,90,71,9,48,4,38,91,82,95,44,92,50,21,60,10,53,73,,34,88
15,19,60,,22,53,66,21,,,49,79,6,,,35,68,81,96,39,10,20,90,95,74,25,68,88,,40,33,65,,,56,98,57,84,15,,76,31,,53,2,15,,42,50,,47,42,,49,,67,61,18,53,29,,63,59,3,60,49,51,7,24,97,51,93,20,53,92,18,2,11,57,93,,13,34,20,98,28,24,68,90,29,94,24,61,,71,13,83,,36,89,34,100,71,,81,26,11,83,6,44,27,37,76,31,66,6,,33,48,37,64,98,22,,79,81,8,88,57,94,33,,37,12,25,61,47,87,46,91,86,10,79,42,85,72,,92,79,51,84,,57,,27,10,9,45,68,89,17,15,14,29,61,100,47,40,,87,10,98,71,5,44,19,65,,20,44,43,80,74,14,92,74,81,20,75,2,21,27,42,26,14,66,61,,8,60
1,72,18,,86,83,13,65,,,35,59,50,,,70,25,94,88,69,97,58,48,100,4,86,31,86,,69,100,81,,,65,66,23,36,20,,67,69,,69,22,57,,,51,,98,67,,41,,59,,16,32,100,,100,12,41,12,76,43,45,81,67,50,42,39,9,28,14,7,40,45,,,17,41,24,57,27,74,9,21,5,51,82,59,,33,76,20,,1,37,5,96,70,,39,76,79,69,93,68,31,7,79,92,18,36,,76,82,25,29,87,77,,27,32,7,75,73,84,92,,50,29,89,43,46,44,70,92,18,47,8,97,35,79,,97,18,16,85,,16,,81,75,8,65,58,32,89,56,69,32,48,8,38,81,,91,88,89,54,89,20,22,76,,81,71,41,40,72,26,2,56,13,2,65,30,73,11,59,64,33,71,17,,67,99
41,13,52,,21,70,86,37,,,81,19,21,,,68,14,91,30,55,93,30,41,35,79,3,40,75,,6,92,11,,,87,37,39,28,56,,2,61,,32,64,69,,,66,,92,16,,97,,99,,17,22,76,,74,63,69,44,57,55,36,29,21,53,78,21,25,27,89,96,1,55,,,77,52,85,64,79,63,55,68,70,39,39,74,,29,87,98,,97,77,27,7,14,,71,45,14,6,45,28,43,10,68,44,31,14,,23,61,97,88,54,93,,69,84,30,94,49,56,69,,58,51,15,33,,92,100,69,65,76,64,56,9,49,,30,23,48,81,,69,,8,,87,98,43,41,79,92,80,26,6,51,34,53,,11,20,11,67,93,42,1,58,,46,70,28,24,81,67,28,40,17,92,78,89,44,99,40,95,35,40,14,,56,69
56,5,53,,20,13,72,2,,,12,27,51,,,7,9,52,31,82,69,2,26,10,10,79,57,,,63,72,47,,,21,90,26,98,97,,95,4,,40,43,23,,,36,,67,72,,77,,4,,38,40,19,,25,5,78,73,62,93,72,26,94,9,70,51,42,7,74,1,50,33,,,91,50,4,65,39,48,72,86,66,22,27,26,,17,35,14,,93,36,22,60,68,,26,29,59,87,39,4,58,55,27,30,44,30,,90,93,85,87,44,41,,67,98,6,92,44,31,81,,56,,81,91,,17,47,2,29,85,21,3,1,12,,21,41,57,9,,76,,94,,89,53,74,93,26,67,11,57,73,35,51,83,,58,92,36,15,16,32,51,5,,14,5,39,99,70,4,85,22,36,4,72,90,37,67,18,16,48,18,80,,84,71
94,10,64,,52,25,8,48,,,79,23,100,,,85,90,35,53,36,13,18,53,37,28,24,78,,,66,6,86,,,,62,22,78,64,,17,58,,100,61,26,,,68,,62,38,,44,,57,,55,82,22,,58,50,9,51,26,25,84,52,39,37,81,18,69,77,61,31,3,24,,,62,36,38,13,65,88,28,95,76,14,76,98,,36,49,,,76,55,79,28,35,,96,42,21,12,77,7,70,,5,67,35,54,,32,23,89,99,94,31,,51,30,93,62,88,38,59,,16,,19,73,,22,80,33,34,24,90,82,14,34,,69,13,62,24,,91,,50,,57,49,10,63,87,64,59,9,65,14,44,2,,62,13,6,89,24,11,93,49,,38,99,80,52,69,75,1,10,66,89,56,53,13,56,25,9,84,3,40,,69,78
9,31,90,,70,78,37,35,,,93,54,8,,,81,34,13,8,43,64,22,12,22,72,55,32,,,90,26,31,,,,91,25,,75,,91,74,,21,67,3,,,37,,36,2,,87,,77,,28,50,78,,41,28,61,16,74,44,50,61,,25,94,12,6,95,23,61,7,97,,,68,83,99,43,77,12,75,39,51,28,10,79,,40,39,,,75,45,8,22,83,,73,85,5,34,51,33,20,,100,77,76,20,,51,66,86,62,69,12,,8,68,51,8,64,34,82,,44,,3,82,,8,10,1,61,61,96,45,62,7,,8,,9,76,,42,,71,,20,2,51,82,15,16,94,78,42,13,90,31,,67,14,57,57,69,27,91,16,,10,64,26,46,62,33,17,63,31,98,51,79,17,25,81,12,26,9,21,,14,
20,78,76,,4,88,29,70,,,55,46,68,,,26,35,82,75,61,72,82,87,63,99,22,25,,,15,59,64,,,,36,54,,24,,96,38,,70,26,95,,,10,,81,50,,94,,44,,95,88,8,,71,39,23,47,79,23,20,41,,76,67,36,58,88,96,39,82,6,,,24,21,88,75,2,45,21,,95,31,53,55,,12,74,,,72,50,53,87,52,,9,44,30,28,46,36,41,,6,95,41,,,19,100,48,92,66,14,,25,,16,19,85,25,53,,45,,79,31,,14,65,80,9,4,34,47,61,13,,58,,15,35,,8,,46,,30,15,96,56,93,20,85,64,3,3,57,14,,18,82,13,,65,45,78,37,,26,22,9,98,36,30,56,73,93,17,81,57,64,57,35,72,82,16,,,42,
8,27,66,,81,31,65,47,,,1,67,90,,,48,15,14,95,37,34,47,44,21,48,48,3,,,9,18,21,,,,3,38,,,,47,73,,60,57,41,,,85,,11,30,,34,,76,,,49,64,,84,32,,13,52,95,19,72,,93,45,66,52,96,25,27,60,38,,,10,12,27,67,75,34,18,,34,92,29,38,,39,69,,,9,22,40,86,97,,65,82,98,94,26,,2,,56,91,32,,,42,89,15,66,1,65,,99,,12,71,84,42,78,,88,,68,17,,41,60,4,33,88,37,36,40,68,,45,,78,71,,73,,31,,96,84,73,50,100,8,45,28,8,89,4,9,,25,5,99,,54,26,43,41,,47,9,12,75,47,28,30,4,65,43,53,19,71,20,36,61,39,15,,,15,
29,95,88,,71,92,98,3,,,16,63,,,,100,6,71,87,85,31,53,38,79,8,59,99,,,7,81,46,,,,97,44,,,,,32,,74,56,40,,,17,,3,10,,53,,11,,,,84,,38,68,,48,35,26,91,82,,66,47,76,95,79,99,24,17,31,,,37,55,84,91,99,89,43,,15,55,70,34,,45,93,,,64,9,84,26,10,,32,19,52,50,18,,85,,40,14,8,,,4,72,76,27,96,34,,89,,22,86,24,40,18,,81,,96,2,,82,94,35,,55,6,79,15,15,,53,,8,78,,72,,97,,24,94,45,90,95,37,68,81,66,29,78,24,,19,67,67,,98,64,69,25,,66,89,42,36,83,29,47,36,39,25,80,28,40,92,84,39,19,82,,,11,
85,87,71,,56,41,59,8,,,52,20,,,,20,12,73,90,23,40,92,29,98,53,31,14,,,23,85,57,,,,94,12,,,,,25,,2,15,18,,,97,,32,88,,72,,43,,,,15,,51,4,,59,7,52,32,59,,3,50,85,27,,88,42,31,99,,,97,3,69,49,66,46,70,,42,33,46,92,,93,56,,,14,95,23,88,,,13,88,32,26,54,,18,,45,9,10,,,94,43,70,83,60,61,,15,,36,3,99,59,40,,33,,65,79,,1,14,31,,51,23,44,65,59,,31,,53,20,,64,,96,,71,36,35,94,4,74,44,43,59,5,74,82,,21,33,68,,77,14,16,81,,19,15,13,23,88,58,99,43,59,91,93,54,43,43,11,86,32,19,,,63,